18 18 18 18 18 18 18 18 18 18 18 18 18 18 18 18 18 18 18 18 18 18 18 18 18 18 18 18 18 18 18 18 18 18 18 18 18 18 18 18 18 18 18 18 18 18 18 18 18 18 18 18 18 18 18 18 18 18 18 18 18 18 18 18 18 18 18 18 18 18 18 18 18 18 18 18 18 18 18 18 18 18 18 18 18 18 18 18 18 18 18 18 18 18 18 18 18 18 18 18 
18 18 18 18 18 18 18 18 18 19 18 18 18 18 18 18 18 18 18 18 18 18 18 18 18 18 18 18 18 18 18 18 18 18 18 18 18 18 18 18 18 18 18 18 18 18 18 18 18 18 18 18 18 18 18 18 18 18 18 18 18 18 18 18 18 18 18 18 18 18 18 18 18 18 18 18 18 18 18 18 18 18 18 18 18 18 18 18 18 18 18 18 18 18 18 18 18 18 18 18 
18 18 18 18 18 18 18 18 18 18 18 18 18 18 18 18 18 18 18 18 18 18 18 18 18 18 18 18 18 18 18 18 18 18 18 18 18 18 18 18 18 18 18 18 18 18 18 18 18 18 18 18 18 18 18 18 18 18 18 18 18 18 18 18 18 18 18 18 18 18 18 18 18 18 18 18 18 18 18 18 18 18 18 18 18 18 18 18 18 18 18 18 18 18 18 18 18 18 18 18 
18 18 18 19 18 18 18 18 18 18 18 18 18 18 18 18 18 18 18 18 18 18 18 18 18 18 18 19 18 18 18 18 18 18 18 19 18 18 18 18 18 18 18 18 18 18 18 18 18 18 18 18 18 18 18 18 18 18 18 18 18 18 18 18 18 18 18 18 18 18 18 18 18 18 18 18 18 18 18 18 18 18 18 18 18 18 18 18 18 18 18 18 18 18 18 18 18 18 18 18 
18 18 18 18 18 18 19 18 18 18 18 18 18 18 18 18 18 19 18 18 18 18 19 18 18 18 18 18 18 18 18 18 18 18 18 18 18 18 18 18 18 18 18 18 18 18 18 18 18 18 18 18 18 18 18 18 18 18 18 18 18 18 18 18 18 18 18 18 18 18 18 18 18 18 18 18 18 18 18 18 18 18 18 18 18 18 18 18 18 18 18 18 18 18 18 18 18 18 18 18 
18 18 18 18 18 18 18 18 18 18 18 18 19 18 18 18 18 18 18 18 18 18 18 18 18 18 18 18 18 19 18 19 18 18 18 18 18 18 18 18 18 18 18 18 18 18 18 18 18 18 18 18 18 18 18 18 18 18 18 18 18 18 18 18 18 18 18 18 18 18 18 18 18 18 18 18 18 18 18 18 18 18 18 18 18 18 18 18 18 18 18 18 18 18 18 18 18 18 18 18 
18 18 18 18 18 18 18 18 28 26 26 26 26 26 26 26 29 18 28 26 26 26 26 26 26 26 26 29 18 18 18 28 26 26 26 26 26 26 26 26 26 26 29 18 18 18 18 18 18 28 26 26 26 26 26 26 26 26 26 26 26 26 26 26 26 26 26 26 26 26 26 26 26 26 26 26 26 26 26 26 26 26 26 26 26 26 26 26 26 26 26 26 26 26 29 18 18 18 18 18 
18 19 18 18 18 18 18 18 24 16 32 32 32 32 32 16 25 26 27 16 1 1 1 1 1 1 1 25 26 26 26 27 16 1 12 10 10 10 10 10 10 13 23 18 18 18 18 18 18 24 1 1 1 1 1 1 1 1 1 1 1 1 1 1 1 1 1 1 1 1 1 1 1 1 1 1 1 1 1 1 1 1 1 1 1 1 1 1 1 1 1 1 1 1 23 18 18 18 18 18 
18 18 18 18 18 18 18 18 24 16 32 37 17 17 32 16 16 16 16 16 1 20 21 21 21 22 1 16 16 16 16 16 16 16 8 3 3 3 3 3 3 7 23 18 18 18 18 18 18 24 1 16 16 16 16 16 16 16 16 16 16 16 16 16 16 16 16 16 16 16 16 16 16 16 16 16 16 16 16 16 16 16 16 1 1 1 1 1 1 1 1 1 1 1 23 18 18 18 18 18 
18 18 18 18 18 18 18 18 24 16 32 17 17 17 32 16 16 16 16 16 1 23 18 18 18 24 1 16 16 16 16 16 16 16 8 3 3 3 3 3 3 7 23 18 18 18 18 18 18 24 1 16 16 16 16 16 16 16 16 16 16 16 16 16 16 16 16 16 16 16 16 16 16 16 16 16 16 16 16 16 16 16 16 1 1 1 1 1 1 1 1 1 1 1 23 18 18 18 18 18 
18 18 18 18 18 18 18 18 24 16 32 17 17 17 32 16 16 16 16 16 1 23 18 18 18 24 1 16 16 16 16 16 16 16 8 3 3 3 3 3 3 7 23 19 18 18 18 18 18 24 1 16 16 16 16 16 16 16 16 16 16 16 16 16 16 16 16 16 16 16 16 16 16 16 16 16 16 16 16 16 16 16 16 1 1 1 1 1 1 1 1 1 1 1 23 18 18 18 18 18 
18 18 19 18 18 18 18 18 24 16 32 17 17 17 32 16 16 16 16 16 1 25 26 26 26 27 1 16 16 16 16 16 16 16 8 3 3 3 3 3 3 7 23 18 18 18 18 18 18 24 1 16 16 16 16 16 16 16 16 16 16 16 16 16 16 16 16 16 16 16 16 16 16 16 16 16 16 16 16 16 16 16 16 1 1 1 1 1 1 1 1 1 1 1 23 18 18 18 18 18 
18 18 18 18 18 19 18 18 24 16 32 32 17 32 32 16 16 16 16 16 1 1 12 10 13 1 1 1 1 1 1 1 1 1 14 5 5 6 3 4 5 15 23 18 18 18 18 18 18 24 1 16 16 16 16 16 16 16 16 16 16 16 16 16 16 16 16 16 16 16 16 16 16 16 16 16 16 16 16 16 16 16 16 1 1 1 1 1 1 1 1 1 1 1 23 18 18 18 18 18 
18 18 18 18 18 18 18 18 24 16 16 16 1 16 16 16 16 16 16 16 16 16 8 3 7 16 16 16 16 16 16 16 16 16 16 16 16 8 3 7 20 21 31 18 18 18 18 18 18 24 1 16 16 16 16 16 16 16 16 16 16 16 16 16 16 16 16 16 16 16 16 16 16 16 16 16 16 16 16 16 16 16 16 16 16 16 16 16 16 16 16 16 1 1 23 18 18 18 18 18 
18 18 18 18 18 18 18 18 30 22 16 16 1 16 16 16 16 16 16 16 16 16 8 3 7 16 16 16 16 16 16 16 16 16 16 16 16 8 3 7 23 18 18 18 18 18 18 18 18 24 1 16 16 16 16 16 16 16 16 16 16 16 16 16 16 16 16 16 16 16 16 16 16 16 16 16 16 16 16 16 16 16 16 16 16 16 16 16 16 16 16 16 1 1 23 18 18 18 18 18 
18 19 18 18 18 18 18 19 18 24 16 16 1 16 16 16 16 16 16 16 16 16 8 3 7 16 16 16 16 16 16 16 16 16 16 16 16 8 3 7 23 19 18 18 18 18 18 18 18 24 1 16 16 16 16 16 16 16 16 16 16 16 16 16 16 16 16 16 16 16 16 16 16 16 16 16 16 16 16 16 16 16 16 16 16 16 16 16 16 16 16 16 1 1 23 18 18 18 18 18 
18 18 18 18 18 18 18 18 28 27 16 16 1 16 16 16 16 16 16 16 16 16 8 3 7 1 1 1 16 16 16 16 16 16 16 16 16 8 3 7 23 18 18 19 18 18 18 18 18 24 1 16 16 16 16 16 16 16 16 16 16 16 16 16 16 16 16 16 16 16 16 16 16 16 16 16 16 16 16 16 16 16 16 16 16 16 16 16 16 16 16 16 1 1 23 18 18 18 18 18 
18 18 18 18 18 18 18 28 27 16 16 16 1 16 16 16 16 16 16 16 16 16 8 3 7 16 16 16 16 16 16 16 16 16 16 12 10 11 3 7 23 18 18 18 18 18 18 18 18 24 1 16 16 16 16 16 16 16 16 16 16 16 16 16 16 16 16 16 16 16 16 16 16 16 16 16 16 16 16 16 16 16 16 16 16 16 16 16 16 16 16 16 1 1 23 18 18 18 18 18 
18 18 18 18 18 18 18 24 16 16 1 1 1 16 16 16 16 16 16 16 16 16 8 3 7 16 16 16 16 16 16 16 16 16 16 8 3 3 3 7 23 18 18 18 18 18 19 18 18 24 1 16 16 16 16 16 16 16 16 16 16 16 16 16 16 16 16 16 16 16 16 16 16 16 16 16 16 16 16 16 16 16 16 16 16 16 16 16 16 16 16 16 1 1 23 18 18 18 18 18 
18 18 18 18 18 19 18 24 16 16 1 16 16 16 16 16 16 16 16 16 16 1 8 3 7 1 16 16 16 16 16 16 16 16 16 8 3 4 5 15 23 18 18 18 18 18 18 18 18 24 1 16 16 16 16 16 16 16 16 16 16 16 16 16 16 16 16 16 16 16 16 16 16 16 16 16 16 16 16 16 16 16 16 16 16 16 16 16 16 16 16 16 1 1 23 18 18 18 18 18 
18 18 18 18 18 18 18 24 16 16 1 16 16 1 12 10 10 10 10 10 10 10 11 3 9 10 10 10 10 13 16 16 16 12 10 11 3 7 1 16 23 18 18 19 18 18 18 18 18 24 1 16 16 16 16 16 16 16 16 16 16 16 16 16 16 16 16 16 16 16 16 16 16 16 16 16 16 16 16 16 16 16 16 16 16 16 16 16 16 16 16 16 1 1 23 18 18 18 18 18 
18 18 18 19 18 18 18 24 16 16 1 16 16 1 8 3 3 3 3 3 3 3 3 3 3 3 3 3 3 7 1 1 1 8 3 3 3 7 1 20 31 18 18 18 18 18 18 18 18 24 1 16 16 16 16 16 16 16 16 16 16 16 16 16 16 16 16 16 16 16 16 16 16 16 16 16 16 16 16 16 16 16 16 16 16 16 16 16 16 16 16 16 1 1 23 18 18 18 18 18 
18 18 18 18 18 18 18 24 16 16 1 16 16 1 14 5 5 5 5 5 5 5 6 3 4 5 5 5 5 15 16 16 16 14 5 6 3 7 2 23 18 18 19 18 18 18 18 18 18 24 1 16 16 16 16 16 16 16 16 16 16 16 16 16 16 16 16 16 16 16 16 16 16 1 1 16 16 16 16 16 16 16 16 16 16 16 16 16 16 16 16 16 1 1 23 18 18 18 18 18 
18 18 18 18 18 18 18 30 22 16 1 16 16 1 16 16 16 16 16 16 16 1 8 3 7 1 16 16 16 16 16 16 16 16 16 8 3 7 1 23 18 18 18 18 18 18 18 18 18 24 1 16 16 16 16 16 16 16 16 16 16 16 16 1 1 1 1 1 1 1 1 1 1 1 1 16 16 16 16 16 16 16 16 16 16 16 16 16 16 16 16 16 1 1 23 18 18 18 18 18 
18 18 18 18 18 18 18 18 24 16 1 16 16 1 16 16 16 16 16 16 16 16 8 3 7 16 16 16 16 16 16 16 16 16 16 8 3 7 1 23 18 18 18 18 18 18 18 18 18 24 1 16 16 16 16 16 16 16 16 16 16 16 16 1 16 16 16 16 16 16 16 16 16 16 1 16 16 16 16 16 16 16 16 16 16 16 16 16 16 16 16 16 1 1 23 18 18 18 18 18 
18 18 18 18 18 18 18 18 27 16 1 16 16 1 1 16 16 16 16 16 16 16 8 3 7 16 16 16 16 16 16 16 16 16 16 8 3 7 1 23 18 18 18 18 18 18 19 18 18 24 1 16 16 16 16 16 16 16 16 16 16 16 16 1 16 16 16 16 16 16 16 16 16 1 1 1 1 1 1 16 16 16 16 16 16 16 16 16 16 16 16 16 1 1 23 18 18 18 18 18 
18 18 18 19 18 18 18 24 16 16 1 16 16 16 1 16 16 16 16 16 16 16 8 3 7 16 16 16 16 16 16 16 16 16 16 8 3 7 1 23 18 18 18 18 18 18 18 18 18 24 1 16 16 16 16 16 16 16 16 16 16 16 16 1 16 16 16 16 16 16 16 16 16 1 1 1 1 1 1 1 16 16 16 16 16 16 16 16 16 16 16 16 1 1 23 18 18 18 18 18 
18 18 18 18 18 18 18 24 16 16 1 16 16 16 1 16 16 16 16 16 16 16 8 3 7 1 1 1 16 16 16 16 16 16 16 8 3 7 1 23 18 18 18 18 18 18 18 18 18 24 1 16 16 16 16 16 16 16 16 16 16 16 16 1 16 16 16 16 16 16 16 16 1 1 1 1 1 1 1 1 1 1 16 16 16 16 16 16 16 16 16 16 1 1 23 18 18 18 18 18 
18 18 18 18 18 18 18 24 16 16 1 16 16 16 1 16 16 16 16 16 16 16 8 3 7 16 16 1 16 16 16 16 16 16 16 8 3 7 1 23 18 18 19 18 18 18 18 18 18 24 1 16 16 16 16 16 16 16 16 16 16 16 16 1 16 16 16 16 16 16 16 16 1 1 1 1 1 33 1 1 1 1 16 16 16 16 16 16 16 16 16 16 1 1 23 18 18 18 18 18 
18 18 19 18 18 18 18 24 16 16 1 1 1 1 1 1 16 16 16 16 16 16 8 3 7 16 16 1 16 16 1 16 16 16 16 14 5 15 1 23 18 18 18 18 18 18 18 18 18 24 1 16 16 16 16 16 16 16 16 16 16 16 16 1 16 16 16 16 16 16 16 16 16 1 1 1 1 1 1 1 1 1 16 16 16 16 16 16 16 16 16 16 1 1 23 18 18 18 18 18 
18 18 18 18 18 18 18 24 16 16 1 2 1 1 1 1 16 16 16 16 16 16 8 3 7 16 16 1 16 16 1 16 16 16 16 16 1 16 20 31 18 18 18 18 18 18 18 18 18 24 1 16 16 16 16 16 16 16 16 16 16 16 16 1 16 16 16 16 16 16 16 16 16 1 1 1 1 1 1 1 1 1 16 16 16 16 16 16 16 16 16 16 1 1 23 18 18 18 18 18 
18 18 18 18 18 18 19 30 22 16 1 1 1 1 1 1 16 16 16 16 16 16 8 3 7 16 16 1 1 1 1 16 16 16 16 16 1 1 23 18 19 18 18 18 18 18 18 18 18 24 1 16 16 16 16 16 16 16 16 16 16 16 16 1 16 16 16 16 16 16 16 16 16 16 16 16 16 16 16 16 16 16 16 16 16 16 16 16 16 16 16 16 16 1 23 18 18 18 18 18 
18 18 18 18 18 18 18 18 24 16 1 1 1 2 1 1 16 16 16 16 16 16 8 3 7 16 16 16 16 16 16 16 16 16 16 1 1 1 23 18 18 18 18 18 18 18 18 19 18 24 1 16 16 16 16 16 16 16 16 16 16 16 16 1 16 16 16 16 16 16 16 16 16 16 16 16 16 16 16 16 16 16 16 16 16 16 16 16 16 16 16 16 16 1 23 18 18 18 18 18 
18 18 18 18 18 18 18 18 24 16 1 1 1 1 1 1 16 16 16 16 16 16 8 3 7 16 16 16 16 16 16 16 16 16 16 1 1 2 23 18 18 18 18 18 18 18 18 18 18 24 1 16 16 16 16 16 16 16 16 16 16 16 16 1 16 16 16 16 16 16 16 16 16 16 16 16 16 16 16 16 16 16 16 16 16 16 16 16 16 16 16 16 16 1 23 18 18 18 18 18 
18 18 18 18 19 18 18 18 24 16 1 1 1 1 1 1 16 16 16 16 16 16 8 3 7 16 16 16 16 16 16 16 16 16 16 1 1 1 23 18 18 18 18 18 18 18 18 18 18 24 1 16 16 16 16 16 16 16 16 16 16 16 16 1 16 16 16 16 16 16 16 16 16 16 16 16 16 16 16 16 16 16 16 16 16 16 16 16 16 16 16 16 16 1 23 18 18 18 18 18 
18 18 18 18 18 18 18 28 27 16 16 16 16 16 16 16 16 16 16 16 16 16 14 5 15 16 16 16 16 16 16 16 16 16 16 1 1 1 25 29 18 18 18 18 18 18 18 18 18 24 1 16 16 16 16 16 16 16 16 16 16 16 16 1 16 16 16 16 16 16 16 16 16 16 16 16 16 16 16 16 16 16 16 16 16 16 16 16 16 16 16 16 16 1 23 18 18 18 18 18 
18 18 18 18 18 18 18 24 16 16 16 16 16 16 16 16 16 16 16 16 1 1 1 1 1 1 1 16 16 16 16 16 16 16 1 1 1 1 1 25 29 18 19 18 18 18 18 18 18 24 1 16 16 16 16 16 16 16 16 16 16 16 16 1 16 16 16 16 16 16 16 16 16 16 16 16 16 16 16 16 16 16 16 16 16 16 16 16 16 16 16 16 16 1 23 18 18 18 18 18 
18 18 18 18 18 18 18 24 16 16 16 16 16 16 16 16 16 16 16 1 1 1 1 2 1 1 1 1 16 16 1 16 16 1 1 2 1 1 1 1 23 18 18 18 18 18 18 18 18 24 1 16 16 16 16 16 16 16 16 16 16 16 16 1 1 1 16 16 16 16 16 16 16 16 16 16 16 16 16 16 16 16 16 16 16 16 16 16 16 16 16 16 16 1 23 18 18 18 18 18 
18 18 18 18 18 18 18 24 16 16 16 16 16 16 16 16 16 16 16 1 1 1 1 1 1 1 1 1 16 16 16 16 1 1 1 1 1 1 1 1 23 18 18 18 18 18 18 18 18 24 1 16 16 16 16 16 16 16 16 16 16 16 16 16 16 1 1 1 1 1 1 1 1 1 1 1 1 1 1 1 1 1 1 1 1 1 1 1 1 1 1 1 1 1 23 18 18 18 18 18 
18 18 18 18 18 18 18 24 16 16 33 16 16 16 16 16 16 16 16 1 1 1 1 1 1 1 2 1 1 16 16 16 1 1 1 1 1 16 1 2 23 18 18 18 18 18 18 18 18 24 1 16 16 16 16 16 16 16 16 16 16 16 16 16 16 16 16 16 16 16 16 16 16 16 16 16 16 16 16 16 16 16 16 16 16 16 16 16 16 16 16 16 16 16 23 18 18 18 18 18 
18 18 18 18 18 19 18 24 16 16 1 16 16 1 1 1 1 1 1 1 2 1 1 1 1 1 1 1 1 1 1 1 1 1 16 1 1 1 1 1 23 18 18 18 18 18 18 18 18 24 1 16 16 16 16 16 16 16 16 16 16 16 16 16 16 16 16 16 16 16 16 16 20 21 21 21 21 21 22 16 16 16 16 16 16 16 16 16 16 16 16 16 16 16 23 18 18 18 18 18 
18 18 18 18 18 18 18 24 16 16 1 1 1 1 16 20 21 21 22 1 1 1 1 1 1 1 1 20 21 21 22 1 1 1 1 1 1 1 1 1 23 18 18 18 18 18 19 18 18 24 1 16 16 16 16 16 16 16 16 16 16 16 16 16 16 16 16 16 16 16 16 16 23 28 26 26 26 29 24 16 16 16 16 16 16 16 16 16 16 16 16 16 16 16 23 18 18 18 18 18 
18 19 18 18 18 18 18 24 16 16 16 16 16 16 20 31 18 18 30 22 1 1 12 10 13 1 20 31 18 18 24 1 1 16 1 1 16 1 1 1 23 18 18 18 18 18 18 18 18 24 1 16 16 16 16 16 16 16 16 16 16 16 16 16 16 16 16 16 16 16 16 16 23 24 20 21 22 23 24 16 16 16 16 16 16 16 16 16 16 16 16 16 16 16 23 18 18 18 18 18 
18 18 18 18 18 18 18 30 21 21 21 21 21 21 31 18 18 18 18 30 21 22 8 3 7 20 31 18 18 18 30 22 1 1 1 1 1 1 20 21 31 18 18 18 18 18 18 18 18 24 1 16 16 16 16 16 16 16 16 16 16 16 16 16 16 16 16 16 16 16 16 16 23 24 25 26 27 23 24 16 16 16 16 16 16 16 16 16 16 16 16 16 16 16 23 18 18 18 18 18 
18 18 18 18 18 18 18 18 18 18 18 18 18 18 19 18 18 18 18 18 18 24 8 3 7 23 18 18 19 18 18 30 21 21 21 21 21 21 31 18 18 18 18 18 18 18 18 18 18 24 1 16 16 16 16 16 16 16 16 16 16 16 16 16 16 16 16 16 16 16 16 16 23 30 21 21 21 31 24 16 16 16 16 16 16 16 16 16 16 16 16 16 16 16 23 18 18 18 18 18 
18 18 18 18 19 18 18 18 18 18 18 18 18 18 18 18 18 18 18 18 18 24 8 3 7 23 18 18 18 18 18 18 19 18 18 18 18 18 18 19 18 18 18 18 18 18 19 18 18 24 1 16 16 16 16 16 16 16 16 16 16 16 16 16 16 16 16 16 16 16 16 16 25 26 26 26 26 26 27 16 16 16 16 16 16 16 16 16 16 16 16 16 16 16 23 18 18 18 18 18 
18 18 18 18 18 18 18 18 18 19 18 18 18 18 18 18 18 18 18 18 18 24 8 3 7 23 18 18 18 18 18 18 18 18 18 18 18 18 18 18 18 18 18 18 18 18 18 18 18 24 1 16 16 16 16 16 16 16 16 16 16 16 16 16 16 16 16 16 16 16 16 16 16 16 16 16 16 16 16 16 16 16 16 16 16 16 16 16 16 16 16 16 16 16 23 18 18 18 18 18 
18 18 18 18 18 18 18 18 18 18 18 18 18 18 18 18 18 18 18 18 18 24 8 3 7 23 18 18 18 18 18 18 18 18 18 18 18 18 18 18 18 18 18 18 18 18 18 18 18 24 1 16 16 16 16 16 16 16 16 16 16 16 16 16 16 16 16 16 16 16 16 16 16 16 16 16 16 16 16 16 16 16 16 16 16 16 16 16 16 16 16 16 16 16 23 18 18 18 18 18 
18 18 18 18 18 18 18 18 18 18 18 18 18 18 18 18 18 18 18 18 18 24 8 3 7 23 18 18 18 18 18 18 18 18 18 18 18 18 18 18 18 18 18 18 18 18 18 18 18 24 1 16 16 16 16 16 16 16 16 16 16 16 16 16 16 16 16 16 16 16 16 16 16 16 16 16 16 16 16 16 16 16 16 16 16 16 16 16 16 16 16 16 16 16 23 18 18 18 18 18 
18 18 18 18 18 18 18 18 18 18 18 19 18 18 18 18 18 18 18 18 18 24 8 3 7 23 18 18 18 18 18 18 18 18 18 18 18 18 18 18 18 18 18 19 18 18 18 18 18 24 1 16 16 16 16 16 16 16 16 16 16 16 16 16 16 16 16 16 16 16 16 16 16 16 16 16 16 16 16 16 16 16 16 16 16 16 16 16 16 16 16 16 16 16 23 18 18 18 18 18 
18 18 18 18 18 18 18 18 18 18 18 18 18 18 18 18 18 18 18 18 18 24 8 3 7 23 18 18 19 18 18 18 18 18 18 18 18 19 18 18 18 18 18 18 18 18 18 18 18 24 1 16 16 16 16 16 16 16 16 16 16 16 16 16 16 16 16 16 16 16 16 16 16 16 16 16 16 16 16 16 16 16 16 16 16 16 16 16 16 16 16 16 16 16 23 18 18 18 18 18 
18 18 18 18 18 18 19 18 18 18 18 18 18 18 18 18 18 19 18 18 18 24 8 3 7 23 18 18 18 18 18 19 18 18 18 18 18 18 18 18 18 18 18 18 18 18 18 18 18 24 1 1 1 1 1 1 1 1 1 1 1 1 1 1 1 1 1 1 1 1 1 1 1 1 1 1 1 1 1 1 1 1 1 1 1 1 1 1 1 1 1 1 1 36 23 18 18 18 18 18 
18 18 18 18 18 18 18 18 18 18 18 18 18 18 18 18 18 18 18 18 18 24 8 3 7 23 18 18 18 18 18 18 18 18 18 18 18 18 18 18 18 18 18 18 18 18 18 18 18 30 21 21 21 21 21 21 21 21 21 21 21 21 21 21 21 21 21 21 21 21 21 21 21 21 21 21 21 21 21 21 21 21 22 1 20 21 22 20 21 21 21 21 21 21 31 18 18 18 18 18 
18 18 18 19 18 18 18 28 26 26 26 26 26 26 26 26 26 26 26 26 26 27 8 3 7 23 26 26 26 26 26 26 26 26 26 26 26 26 26 26 26 26 26 26 26 26 29 28 26 26 26 26 26 26 26 26 26 26 26 26 26 26 26 26 26 26 26 26 26 26 26 26 26 26 26 26 26 26 26 26 26 26 27 1 25 26 27 25 26 26 26 26 26 26 29 18 18 18 18 18 
18 18 18 18 18 18 18 24 32 32 32 32 32 32 16 16 16 16 16 16 16 16 8 3 7 16 32 32 32 32 32 32 32 32 32 32 32 32 32 32 32 32 32 32 32 32 23 24 16 16 16 16 16 16 16 16 16 16 16 16 16 16 16 16 16 16 16 16 16 16 16 16 16 16 16 16 16 16 16 16 16 16 12 10 13 1 1 1 1 1 1 1 1 16 23 18 18 18 18 18 
18 18 18 18 18 18 18 24 17 17 17 17 17 32 16 16 16 16 16 16 16 16 8 3 7 16 32 16 16 16 16 16 16 16 16 16 16 16 16 16 16 16 16 16 16 32 23 24 16 16 16 1 1 1 1 1 1 1 1 1 1 1 1 1 1 1 1 1 1 1 1 1 1 1 1 1 1 1 1 1 1 1 8 3 7 16 16 16 16 16 16 16 1 16 23 18 18 18 18 18 
18 18 18 18 18 18 18 24 32 17 17 36 17 32 16 16 16 16 16 16 16 16 8 3 7 16 32 16 16 16 16 16 16 16 16 16 16 16 16 16 16 16 16 16 16 32 23 24 16 16 16 16 1 16 16 16 16 16 16 16 16 16 16 16 16 16 16 16 16 16 16 16 16 16 16 16 16 16 16 16 16 16 8 3 7 16 16 16 16 16 16 16 1 16 23 18 18 18 18 18 
18 18 18 18 18 18 18 24 32 17 17 17 17 32 16 16 16 16 16 16 16 16 8 3 7 16 32 16 16 1 1 1 1 1 1 1 1 1 1 1 1 1 1 1 1 32 23 24 16 16 16 16 1 16 16 16 16 16 16 16 16 16 16 16 16 16 16 16 16 16 16 16 16 16 16 16 16 16 16 16 16 16 8 3 7 16 16 16 16 16 16 16 1 16 23 18 18 18 18 18 
18 18 18 18 19 18 18 24 32 17 32 32 32 32 16 16 16 16 16 16 16 16 8 3 7 16 32 16 16 1 16 16 16 16 16 16 16 16 16 16 16 16 16 16 1 32 23 24 16 16 16 16 1 16 16 16 16 16 16 16 16 16 16 16 16 16 16 16 16 16 16 16 16 16 16 16 16 16 16 16 16 16 8 3 7 16 16 16 16 16 16 16 1 16 23 18 18 18 18 18 
18 18 18 18 18 18 18 24 16 1 1 1 1 1 16 16 16 16 16 16 16 16 8 3 7 16 32 16 16 1 16 16 16 16 16 16 16 16 16 16 16 16 16 16 1 32 23 24 16 16 16 16 1 16 16 16 16 16 16 16 16 16 16 16 16 16 16 16 16 16 16 16 16 16 16 16 16 16 16 16 16 16 8 3 7 16 16 16 16 16 16 16 1 16 23 18 18 18 18 18 
18 18 18 18 18 18 18 24 1 16 16 16 16 1 16 16 16 16 16 16 16 16 8 3 7 16 32 16 16 1 1 1 1 1 1 1 1 1 1 1 1 1 16 16 1 32 23 24 16 16 16 16 1 16 16 16 16 16 16 16 16 16 16 16 16 16 16 16 16 16 16 16 16 16 16 16 16 16 16 16 16 16 8 3 7 16 16 16 16 16 16 16 1 16 23 18 18 18 18 18 
18 18 18 18 18 18 18 24 1 16 16 1 1 1 16 16 16 16 16 16 16 16 8 3 7 16 32 16 16 1 16 16 16 16 16 16 16 16 16 16 16 1 16 16 1 32 23 24 16 16 16 16 1 16 16 16 16 16 16 16 16 16 16 16 16 16 16 16 16 16 16 16 16 16 16 16 16 16 16 16 16 16 8 3 7 16 16 16 16 16 16 16 1 16 23 18 18 18 18 18 
18 18 18 18 18 18 18 24 1 16 16 1 16 16 16 16 16 16 16 16 16 16 8 3 7 16 32 16 16 16 1 16 16 16 16 16 16 16 16 16 16 1 16 16 1 32 23 24 16 16 16 16 1 16 16 16 16 16 16 16 16 16 16 16 16 16 16 16 16 16 16 16 16 16 16 16 16 16 16 16 16 16 8 3 7 16 16 16 16 16 16 16 1 16 23 18 18 18 18 18 
18 18 18 18 18 18 18 24 1 16 16 1 16 16 16 16 16 16 16 16 16 16 8 3 7 16 32 16 1 1 1 16 33 16 16 16 16 16 16 16 16 1 16 16 1 32 23 24 16 16 16 16 1 1 1 1 1 1 1 1 1 1 1 1 1 1 1 1 1 1 1 16 16 16 16 16 16 16 16 16 16 16 8 3 7 16 16 16 16 16 16 16 1 16 23 18 18 18 18 18 
18 18 18 18 18 18 18 24 1 16 16 1 1 16 16 16 16 16 16 16 16 16 8 3 7 16 32 16 1 1 1 1 1 1 16 16 16 16 16 16 16 1 16 16 1 32 23 24 16 16 16 16 16 16 16 16 16 16 16 16 16 16 16 16 16 16 16 16 16 16 16 16 16 16 16 16 16 16 16 16 16 16 8 3 7 16 16 16 16 16 16 16 1 16 23 18 18 18 18 18 
18 18 18 18 18 18 18 24 1 16 16 16 1 1 16 16 16 16 16 16 16 16 8 3 7 16 32 16 1 33 1 1 1 33 1 16 16 16 16 16 16 1 16 16 1 32 23 24 16 16 16 16 16 16 16 16 16 16 16 16 16 16 16 16 16 16 16 16 16 16 16 16 16 16 16 16 16 16 16 16 16 16 8 3 7 16 16 16 16 16 16 16 1 16 23 18 18 18 18 18 
18 18 18 18 18 18 18 24 1 16 16 16 16 1 16 16 16 16 16 16 16 16 8 3 7 16 32 1 1 1 1 1 1 1 1 1 16 16 16 16 16 1 16 16 1 32 23 24 16 16 16 16 16 16 16 16 16 16 16 16 16 16 16 16 16 16 16 16 16 16 16 16 16 16 16 16 16 16 16 16 16 16 8 3 7 16 16 16 16 16 16 16 1 16 23 18 18 18 18 18 
18 18 18 18 18 18 18 24 1 16 16 16 16 1 16 16 16 16 16 16 16 16 8 3 7 16 32 1 1 1 1 33 1 1 1 1 1 1 16 16 16 1 16 16 1 32 23 24 16 16 16 16 16 16 16 16 16 16 16 16 16 16 16 16 16 16 16 16 16 16 16 16 16 16 16 16 16 16 16 16 16 16 8 3 7 16 16 16 16 16 16 16 1 16 23 18 18 18 18 18 
18 18 18 18 18 18 18 24 1 16 16 16 16 1 1 1 16 16 16 16 16 16 8 3 7 16 32 1 33 1 1 1 1 1 33 1 1 33 1 16 16 1 16 16 1 32 23 24 16 16 16 16 16 16 16 16 16 16 16 16 16 16 16 16 16 16 16 16 16 16 16 16 16 16 16 16 16 16 16 16 16 16 8 3 7 16 16 16 16 16 16 16 1 16 23 18 18 18 18 18 
18 18 18 18 18 18 18 24 1 16 16 16 16 16 16 1 16 16 16 16 16 16 8 3 7 16 32 1 1 1 1 1 1 1 1 1 1 1 1 16 16 1 16 16 1 32 23 24 16 16 16 16 16 16 16 16 16 16 16 16 16 16 16 16 16 16 16 16 16 16 16 16 16 16 16 16 16 16 16 16 16 16 8 3 7 16 16 16 16 16 16 16 1 16 23 18 18 18 18 18 
18 18 18 18 18 18 18 24 1 16 16 16 16 16 16 1 16 16 16 16 16 16 8 3 7 16 32 1 1 1 1 1 33 1 1 1 1 1 1 1 1 1 16 16 1 32 23 24 16 16 16 16 16 16 16 16 16 16 16 16 16 16 16 16 16 16 16 16 16 16 16 16 16 16 16 16 16 16 16 16 16 16 8 3 7 16 16 16 16 16 16 16 1 16 23 18 18 18 18 18 
18 18 18 18 18 18 18 24 1 16 16 16 16 16 16 1 16 16 16 16 16 16 8 3 7 16 32 32 32 32 32 32 32 32 32 32 32 32 32 32 32 32 32 32 1 32 25 27 1 1 1 16 16 16 16 16 16 16 16 16 16 16 16 16 16 16 16 16 16 16 16 16 16 16 16 16 16 16 16 16 16 16 8 3 7 16 16 16 16 16 16 16 1 16 23 18 18 18 18 18 
18 18 18 18 18 18 18 24 2 16 16 16 16 16 1 1 16 16 16 16 16 16 8 3 9 10 10 10 10 10 10 10 10 10 10 10 10 10 10 10 10 10 10 10 10 10 10 10 10 10 10 10 10 10 10 10 10 10 10 10 10 10 10 10 10 10 10 10 10 10 10 10 10 10 10 10 10 10 10 10 10 10 11 3 7 16 16 16 16 16 16 16 1 16 23 18 18 18 18 18 
18 18 18 18 18 18 18 24 2 16 1 1 1 1 1 16 16 16 16 16 16 16 8 3 3 3 3 3 3 3 3 3 3 3 3 3 3 3 3 3 3 3 3 3 3 3 3 3 3 3 3 3 3 3 3 3 3 3 3 3 3 3 3 3 3 3 3 3 3 3 3 3 3 3 3 3 3 3 3 3 3 3 3 3 7 16 16 16 16 16 16 16 1 16 23 18 18 18 18 18 
18 18 18 18 18 18 18 24 2 16 16 1 16 16 16 16 16 16 16 16 16 16 14 5 5 5 5 5 5 5 5 5 5 5 5 5 5 5 5 5 5 5 5 5 5 5 5 5 5 5 5 5 5 5 5 5 5 5 5 5 5 5 5 5 5 5 5 5 5 5 5 5 5 5 5 5 5 5 5 5 5 5 5 5 15 16 16 16 16 16 16 16 1 16 23 18 18 18 18 18 
18 18 18 18 18 18 18 24 1 16 16 1 16 16 16 16 16 16 16 16 16 16 16 16 16 16 16 16 16 16 16 16 16 16 16 16 16 16 16 16 16 16 16 16 16 16 20 22 16 16 16 16 16 16 16 16 16 16 16 16 16 16 16 16 16 16 16 16 16 16 16 16 16 16 16 16 16 16 16 16 16 16 16 16 16 16 16 16 16 16 16 16 1 16 23 18 18 18 18 18 
18 18 18 18 18 18 18 24 1 16 16 1 16 16 16 16 16 16 16 16 16 16 16 16 16 16 16 16 16 16 16 16 20 21 21 21 21 22 16 16 16 16 16 16 16 16 23 24 16 16 16 16 16 16 16 16 16 16 16 16 16 16 16 16 16 16 16 16 16 16 16 16 16 16 16 16 16 16 16 16 16 16 16 16 16 16 16 16 16 16 16 1 1 16 23 18 18 18 18 18 
18 18 18 18 18 18 18 24 1 16 16 1 16 16 16 16 16 16 16 16 16 16 16 16 16 16 16 16 16 16 16 16 23 18 18 18 19 24 16 16 16 16 16 16 16 16 23 24 16 16 16 16 16 16 16 16 16 16 16 16 16 16 16 16 16 16 16 16 16 16 16 16 16 16 16 16 16 16 16 16 16 16 16 16 16 16 16 16 16 16 1 1 16 16 23 18 18 18 18 18 
18 18 18 18 18 18 18 24 1 16 16 1 16 16 16 1 1 1 1 16 16 1 1 1 16 16 16 16 16 16 16 16 23 18 19 18 18 24 1 1 1 1 16 16 16 16 23 24 16 16 16 16 16 16 16 16 16 16 16 16 16 1 1 1 1 16 16 16 16 16 16 16 16 16 16 16 32 32 32 32 32 32 32 32 32 32 32 16 16 16 1 1 16 16 23 18 18 18 18 18 
18 18 18 18 18 18 18 24 1 16 16 1 1 1 1 1 16 16 1 16 16 1 16 1 1 16 16 16 16 16 16 16 25 26 26 26 26 27 1 16 16 1 16 16 16 16 23 24 16 16 1 1 1 1 16 16 1 1 1 1 1 1 16 1 16 16 16 16 16 16 16 16 16 16 16 32 32 2 2 2 2 2 2 2 1 1 32 16 16 16 1 1 16 16 23 18 18 18 18 18 
18 18 18 18 18 18 18 24 1 16 16 16 16 16 16 16 16 16 1 1 1 1 16 16 1 16 16 16 16 16 1 16 16 1 1 1 1 1 1 16 16 1 16 16 16 16 23 24 16 1 1 20 22 1 1 1 1 16 1 16 16 16 16 1 1 16 16 16 16 16 16 16 16 16 16 32 1 20 21 21 21 21 21 21 22 1 32 16 16 16 1 1 16 16 23 18 18 18 18 18 
18 18 18 18 18 18 18 24 1 16 16 16 16 16 20 21 21 21 21 21 22 16 16 16 1 16 16 16 1 1 1 1 20 21 21 21 21 21 22 16 1 1 16 16 16 16 25 27 16 1 20 31 30 21 21 21 21 22 1 16 16 16 16 16 1 1 16 16 16 16 16 16 1 1 1 1 1 23 28 26 26 26 26 29 24 1 32 16 16 16 1 1 16 16 23 18 18 18 18 18 
18 18 18 18 18 18 18 24 1 16 16 16 16 16 25 29 18 19 18 28 27 16 16 16 1 1 1 1 1 16 16 1 25 26 29 18 18 19 24 16 1 16 16 16 16 16 16 16 16 1 25 26 26 26 29 19 19 24 1 16 16 16 16 16 16 1 1 1 1 16 1 1 1 16 16 32 1 23 24 2 1 1 2 23 24 1 32 16 16 1 1 1 16 16 23 18 18 18 18 18 
18 18 18 18 18 18 18 24 1 16 16 16 16 16 16 23 18 28 26 27 16 16 16 16 16 16 16 16 16 16 16 1 1 1 23 19 18 18 24 16 1 16 16 16 16 1 1 1 1 1 1 1 1 16 25 29 19 24 1 16 16 16 16 1 1 1 16 16 1 1 1 16 16 16 16 32 2 23 24 1 16 16 1 23 24 2 32 16 16 1 16 16 16 16 23 18 18 18 18 18 
18 18 18 18 18 18 18 24 1 16 16 16 16 16 16 23 18 24 1 1 1 1 1 1 16 16 16 16 16 16 16 16 16 1 23 18 18 19 24 16 1 1 16 1 1 1 20 22 16 16 1 16 1 16 16 25 26 27 1 16 16 16 16 1 16 16 16 16 16 1 16 16 16 16 16 32 2 23 24 1 36 16 1 23 24 2 32 16 16 1 16 16 16 16 23 18 18 18 18 18 
18 18 18 18 18 18 18 24 2 16 16 16 16 16 20 31 19 30 21 21 21 22 16 1 16 16 16 16 16 16 16 16 16 1 25 29 19 18 30 22 16 1 16 16 1 16 23 24 16 16 1 16 1 1 16 1 1 1 1 16 16 16 16 1 16 16 16 16 16 1 1 1 1 16 16 32 1 23 24 2 2 1 1 23 24 2 32 16 16 1 1 16 16 16 23 18 18 18 18 18 
18 18 18 18 18 18 18 24 2 16 16 16 20 21 31 19 18 18 19 18 18 30 22 1 16 16 16 16 16 16 16 16 16 1 1 25 26 26 26 27 16 1 1 1 1 16 23 24 16 16 1 16 16 1 1 1 16 16 16 16 1 1 1 1 16 16 16 16 16 1 16 16 16 16 16 32 2 23 30 21 21 21 21 31 24 1 32 16 16 16 1 16 16 16 23 18 18 18 18 18 
18 18 18 18 18 18 18 24 2 20 21 21 18 18 28 26 26 29 18 19 18 18 24 1 16 16 16 16 16 16 16 16 16 16 1 1 16 16 16 16 16 1 16 16 16 16 25 27 16 16 1 16 16 16 16 1 16 16 16 16 1 16 16 16 16 16 16 1 1 1 16 16 16 16 16 32 1 25 26 26 26 26 26 26 27 1 32 16 16 16 1 1 16 16 23 18 18 18 18 18 
18 18 18 18 18 18 18 24 2 25 26 26 26 26 27 16 16 25 26 18 18 18 24 1 16 16 16 16 16 16 16 16 16 16 16 1 1 1 1 1 1 1 16 16 16 16 1 1 1 1 1 1 1 1 1 1 16 1 1 1 1 16 16 16 16 16 1 1 16 16 16 16 16 16 16 32 1 1 1 1 1 2 2 2 2 1 32 16 1 1 1 1 1 1 23 18 18 18 18 18 
18 18 18 18 18 18 18 24 2 1 1 1 1 1 16 16 16 16 16 25 26 26 27 1 16 16 16 16 16 16 16 16 16 16 16 16 16 16 16 16 16 16 16 16 16 1 1 16 16 16 16 16 16 16 16 16 16 16 16 16 16 16 16 1 1 1 1 16 16 16 16 16 16 16 16 32 32 32 32 32 32 32 32 32 32 32 32 16 1 1 1 1 1 1 23 18 18 18 18 18 
18 18 18 18 18 18 18 24 16 16 16 16 16 2 16 16 16 16 16 16 16 16 16 1 16 16 16 16 16 16 16 16 16 16 16 16 16 16 16 16 16 1 1 1 16 1 16 16 16 16 16 16 16 16 16 16 16 16 16 16 16 16 16 16 16 1 16 16 16 16 16 16 16 16 16 16 16 16 16 16 16 16 16 16 16 16 16 16 1 1 1 1 1 1 23 18 18 18 18 18 
18 18 18 18 18 18 18 24 16 16 16 16 16 2 2 1 1 1 1 1 1 1 1 1 1 1 1 1 1 1 1 1 1 1 1 1 1 1 1 1 1 1 1 1 1 1 1 1 1 1 1 1 1 1 1 1 1 1 1 1 1 1 1 1 1 1 1 1 1 1 1 1 1 1 1 1 1 1 1 1 1 1 1 1 1 1 1 1 1 1 1 1 1 1 23 18 18 18 18 18 
18 18 18 18 18 18 18 24 16 16 16 16 16 16 16 16 16 16 16 16 16 16 16 16 16 16 16 16 16 16 16 16 16 16 16 16 16 16 16 16 16 16 16 16 16 16 20 22 16 16 16 16 16 16 16 16 16 16 16 16 16 16 16 16 16 16 16 16 16 16 16 16 16 16 16 16 16 16 16 16 16 16 16 16 16 16 16 16 1 1 1 1 1 1 23 18 18 18 18 18 
18 18 18 18 18 18 18 30 21 21 21 21 21 21 21 21 21 21 21 21 21 21 21 21 21 21 21 21 21 21 21 21 21 21 21 21 21 21 21 21 21 21 21 21 21 21 31 30 21 21 21 21 21 21 21 21 21 21 21 21 21 21 21 21 21 21 21 21 21 21 21 21 21 21 21 21 21 21 21 21 21 21 21 21 21 21 21 21 21 21 21 21 21 21 31 18 18 18 18 18 
18 18 18 18 18 18 18 18 18 18 18 18 18 18 18 18 18 18 18 18 18 18 18 18 18 18 18 18 18 18 18 18 18 18 18 18 18 18 18 18 18 18 18 18 18 18 18 18 18 18 18 18 18 18 18 18 18 18 18 18 18 18 18 18 18 18 18 18 18 18 18 18 18 18 18 18 18 18 18 18 18 18 18 18 18 18 18 18 18 18 18 18 18 18 18 18 18 18 18 18 
18 18 18 18 18 18 18 18 18 18 18 18 18 18 18 18 18 18 18 18 18 18 18 18 18 18 18 18 18 18 18 18 18 18 18 18 18 18 18 18 18 18 18 18 18 18 18 18 18 18 18 18 18 18 18 18 18 18 18 18 18 18 18 18 18 18 18 18 18 18 18 18 18 18 18 18 18 18 18 18 18 18 18 18 18 18 18 18 18 18 18 18 18 18 18 18 18 18 18 18 
18 18 18 18 18 18 18 18 18 18 18 18 18 18 18 18 18 18 18 18 18 18 18 18 18 18 18 18 18 18 18 18 18 18 18 18 18 18 18 18 18 18 18 18 18 18 18 18 18 18 18 18 18 18 18 18 18 18 18 18 18 18 18 18 18 18 18 18 18 18 18 18 18 18 18 18 18 18 18 18 18 18 18 18 18 18 18 18 18 18 18 18 18 18 18 18 18 18 18 18 
18 18 18 18 18 18 18 18 18 18 18 18 18 18 18 18 18 18 18 18 18 18 18 18 18 18 18 18 18 18 18 18 18 18 18 18 18 18 18 18 18 18 18 18 18 18 18 18 18 18 18 18 18 18 18 18 18 18 18 18 18 18 18 18 18 18 18 18 18 18 18 18 18 18 18 18 18 18 18 18 18 18 18 18 18 18 18 18 18 18 18 18 18 18 18 18 18 18 18 18 
18 18 18 18 18 18 18 18 18 18 18 18 18 18 18 18 18 18 18 18 18 18 18 18 18 18 18 18 18 18 18 18 18 18 18 18 18 18 18 18 18 18 18 18 18 18 18 18 18 18 18 18 18 18 18 18 18 18 18 18 18 18 18 18 18 18 18 18 18 18 18 18 18 18 18 18 18 18 18 18 18 18 18 18 18 18 18 18 18 18 18 18 18 18 18 18 18 18 18 18 
18 18 18 18 18 18 18 18 18 18 18 18 18 18 18 18 18 18 18 18 18 18 18 18 18 18 18 18 18 18 18 18 18 18 18 18 18 18 18 18 18 18 18 18 18 18 18 18 18 18 18 18 18 18 18 18 18 18 18 18 18 18 18 18 18 18 18 18 18 18 18 18 18 18 18 18 18 18 18 18 18 18 18 18 18 18 18 18 18 18 18 18 18 18 18 18 18 18 18 18 
